START
|00|00|00|00|00|00|00|00|00|00|00|00|00|00|00|00|00|00|00|00|
|00|  |00|  |00|00|00|00|00|00|00|00|00|00|00|00|  |00|  |00|
|00|00|  |00|00|00|00|00|00|00|00|00|00|00|00|00|00|  |00|00|
|00|00|00|00|00|00|00|00|00|00|00|00|00|00|00|00|00|00|00|00|
|00|00|00|00|00|00|00|00|00|00|00|00|00|00|00|00|00|00|00|00|
|00|00|00|00|00|  |  |  |  |  |  |  |  |  |  |00|00|00|00|00|
|00|00|00|00|00|  |  |  |  |  |  |  |  |  |  |00|00|00|00|00|

GFX=DEFAULT
