START
|01|01|01|01|01|01|01|01|01|01|01|01|01|01|01|01|01|01|01|01|
|01|  |01|  |01|01|01|01|01|01|01|01|01|01|01|01|  |01|  |01|
|01|01|  |01|01|01|01|01|01|01|01|01|01|01|01|01|01|  |01|01|
|01|01|01|01|01|01|01|01|01|01|01|01|01|01|01|01|01|01|01|01|
|01|01|01|01|01|01|01|01|01|01|01|01|01|01|01|01|01|01|01|01|
|01|01|01|01|01|  |  |  |  |  |  |  |  |  |  |01|01|01|01|01|
|01|01|01|01|01|  |  |  |  |  |  |  |  |  |  |01|01|01|01|01|

GFX=DEFAULT
